[
  [
    { "x": 0, "y": 0, "w": 2, "h": 1 },
    { "x": 0, "y": 1, "w": 2, "h": 1 },
    { "x": 0, "y": 2, "w": 2, "h": 1 },
    { "x": 0, "y": 3, "w": 2, "h": 1 }
  ],
  [
    { "x": 0, "y": 0, "w": 2, "h": 1 },
    { "x": 0, "y": 1, "w": 2, "h": 1 },
    { "x": 0, "y": 2, "w": 2, "h": 1 },
    { "x": 0, "y": 3, "w": 1, "h": 1 },
    { "x": 1, "y": 3, "w": 1, "h": 1 }
  ],
  [
    { "x": 0, "y": 0, "w": 2, "h": 1 },
    { "x": 0, "y": 1, "w": 2, "h": 1 },
    { "x": 0, "y": 2, "w": 1, "h": 1 },
    { "x": 1, "y": 2, "w": 1, "h": 1 },
    { "x": 0, "y": 3, "w": 2, "h": 1 }
  ],
  [
    { "x": 0, "y": 0, "w": 2, "h": 1 },
    { "x": 0, "y": 1, "w": 2, "h": 1 },
    { "x": 0, "y": 2, "w": 1, "h": 1 },
    { "x": 1, "y": 2, "w": 1, "h": 1 },
    { "x": 0, "y": 3, "w": 1, "h": 1 },
    { "x": 1, "y": 3, "w": 1, "h": 1 }
  ],
  [
    { "x": 0, "y": 0, "w": 2, "h": 1 },
    { "x": 0, "y": 1, "w": 1, "h": 1 },
    { "x": 1, "y": 1, "w": 1, "h": 1 },
    { "x": 0, "y": 2, "w": 1, "h": 1 },
    { "x": 1, "y": 2, "w": 1, "h": 1 },
    { "x": 0, "y": 3, "w": 2, "h": 1 }
  ],
  [
    { "x": 0, "y": 0, "w": 2, "h": 1 },
    { "x": 0, "y": 1, "w": 1, "h": 1 },
    { "x": 1, "y": 1, "w": 1, "h": 1 },
    { "x": 0, "y": 2, "w": 2, "h": 1 },
    { "x": 0, "y": 3, "w": 2, "h": 1 }
  ],
  [
    { "x": 0, "y": 0, "w": 2, "h": 1 },
    { "x": 0, "y": 1, "w": 1, "h": 1 },
    { "x": 1, "y": 1, "w": 1, "h": 1 },
    { "x": 0, "y": 2, "w": 2, "h": 1 },
    { "x": 0, "y": 3, "w": 1, "h": 1 },
    { "x": 1, "y": 3, "w": 1, "h": 1 }
  ],
  [
    { "x": 0, "y": 0, "w": 2, "h": 1 },
    { "x": 0, "y": 1, "w": 1, "h": 1 },
    { "x": 1, "y": 1, "w": 1, "h": 1 },
    { "x": 0, "y": 2, "w": 1, "h": 1 },
    { "x": 1, "y": 2, "w": 1, "h": 1 },
    { "x": 0, "y": 3, "w": 1, "h": 1 },
    { "x": 1, "y": 3, "w": 1, "h": 1 }
  ],
  [
    { "x": 0, "y": 0, "w": 2, "h": 1 },
    { "x": 0, "y": 1, "w": 2, "h": 1 },
    { "x": 0, "y": 2, "w": 2, "h": 2 }
  ],
  [
    { "x": 0, "y": 0, "w": 2, "h": 1 },
    { "x": 0, "y": 1, "w": 1, "h": 1 },
    { "x": 1, "y": 1, "w": 1, "h": 1 },
    { "x": 0, "y": 2, "w": 2, "h": 2 }
  ],
  [
    { "x": 0, "y": 0, "w": 2, "h": 1 },
    { "x": 0, "y": 1, "w": 2, "h": 2 },
    { "x": 0, "y": 3, "w": 2, "h": 1 }
  ],
  [
    { "x": 0, "y": 0, "w": 2, "h": 1 },
    { "x": 0, "y": 1, "w": 2, "h": 2 },
    { "x": 0, "y": 3, "w": 1, "h": 1 },
    { "x": 1, "y": 3, "w": 1, "h": 1 }
  ],
  [
    { "x": 0, "y": 0, "w": 1, "h": 1 },
    { "x": 1, "y": 0, "w": 1, "h": 1 },
    { "x": 0, "y": 1, "w": 1, "h": 1 },
    { "x": 1, "y": 1, "w": 1, "h": 1 },
    { "x": 0, "y": 2, "w": 1, "h": 1 },
    { "x": 1, "y": 2, "w": 1, "h": 1 },
    { "x": 0, "y": 3, "w": 1, "h": 1 },
    { "x": 1, "y": 3, "w": 1, "h": 1 }
  ],
  [
    { "x": 0, "y": 0, "w": 1, "h": 1 },
    { "x": 1, "y": 0, "w": 1, "h": 1 },
    { "x": 0, "y": 1, "w": 1, "h": 1 },
    { "x": 1, "y": 1, "w": 1, "h": 1 },
    { "x": 0, "y": 2, "w": 1, "h": 1 },
    { "x": 1, "y": 2, "w": 1, "h": 1 },
    { "x": 0, "y": 3, "w": 2, "h": 1 }
  ],
  [
    { "x": 0, "y": 0, "w": 1, "h": 1 },
    { "x": 1, "y": 0, "w": 1, "h": 1 },
    { "x": 0, "y": 1, "w": 1, "h": 1 },
    { "x": 1, "y": 1, "w": 1, "h": 1 },
    { "x": 0, "y": 2, "w": 2, "h": 1 },
    { "x": 0, "y": 3, "w": 1, "h": 1 },
    { "x": 1, "y": 3, "w": 1, "h": 1 }
  ],
  [
    { "x": 0, "y": 0, "w": 1, "h": 1 },
    { "x": 1, "y": 0, "w": 1, "h": 1 },
    { "x": 0, "y": 1, "w": 2, "h": 1 },
    { "x": 0, "y": 2, "w": 1, "h": 1 },
    { "x": 1, "y": 2, "w": 1, "h": 1 },
    { "x": 0, "y": 3, "w": 1, "h": 1 },
    { "x": 1, "y": 3, "w": 1, "h": 1 }
  ],
  [
    { "x": 0, "y": 0, "w": 1, "h": 1 },
    { "x": 1, "y": 0, "w": 1, "h": 1 },
    { "x": 0, "y": 1, "w": 1, "h": 1 },
    { "x": 1, "y": 1, "w": 1, "h": 1 },
    { "x": 0, "y": 2, "w": 2, "h": 1 },
    { "x": 0, "y": 3, "w": 2, "h": 1 }
  ],
  [
    { "x": 0, "y": 0, "w": 1, "h": 1 },
    { "x": 1, "y": 0, "w": 1, "h": 1 },
    { "x": 0, "y": 1, "w": 2, "h": 1 },
    { "x": 0, "y": 2, "w": 2, "h": 1 },
    { "x": 0, "y": 3, "w": 1, "h": 1 },
    { "x": 1, "y": 3, "w": 1, "h": 1 }
  ],
  [
    { "x": 0, "y": 0, "w": 1, "h": 1 },
    { "x": 1, "y": 0, "w": 1, "h": 1 },
    { "x": 0, "y": 1, "w": 2, "h": 1 },
    { "x": 0, "y": 2, "w": 2, "h": 1 },
    { "x": 0, "y": 3, "w": 2, "h": 1 }
  ],
  [
    { "x": 0, "y": 0, "w": 1, "h": 1 },
    { "x": 1, "y": 0, "w": 1, "h": 1 },
    { "x": 0, "y": 1, "w": 2, "h": 1 },
    { "x": 0, "y": 2, "w": 2, "h": 1 },
    { "x": 0, "y": 3, "w": 2, "h": 1 }
  ],
  [
    { "x": 0, "y": 0, "w": 1, "h": 1 },
    { "x": 1, "y": 0, "w": 1, "h": 1 },
    { "x": 0, "y": 1, "w": 2, "h": 1 },
    { "x": 0, "y": 2, "w": 1, "h": 1 },
    { "x": 1, "y": 2, "w": 1, "h": 1 },
    { "x": 0, "y": 3, "w": 2, "h": 1 }
  ],
  [
    { "x": 0, "y": 0, "w": 1, "h": 1 },
    { "x": 1, "y": 0, "w": 1, "h": 1 },
    { "x": 0, "y": 1, "w": 1, "h": 1 },
    { "x": 0, "y": 2, "w": 2, "h": 2 }
  ],
  [
    { "x": 0, "y": 0, "w": 1, "h": 1 },
    { "x": 1, "y": 0, "w": 1, "h": 1 },
    { "x": 0, "y": 1, "w": 2, "h": 1 },
    { "x": 1, "y": 1, "w": 2, "h": 1 },
    { "x": 0, "y": 2, "w": 2, "h": 2 }
  ],
  [
    { "x": 0, "y": 0, "w": 1, "h": 1 },
    { "x": 1, "y": 0, "w": 1, "h": 1 },
    { "x": 0, "y": 1, "w": 2, "h": 2 },
    { "x": 0, "y": 3, "w": 2, "h": 1 }
  ],
  [
    { "x": 0, "y": 0, "w": 1, "h": 1 },
    { "x": 1, "y": 0, "w": 1, "h": 1 },
    { "x": 0, "y": 1, "w": 2, "h": 2 },
    { "x": 0, "y": 3, "w": 1, "h": 1 },
    { "x": 1, "y": 3, "w": 1, "h": 1 }
  ],
  [
    { "x": 0, "y": 0, "w": 2, "h": 2 },
    { "x": 0, "y": 2, "w": 2, "h": 2 }
  ],
  [
    { "x": 0, "y": 0, "w": 2, "h": 2 },
    { "x": 0, "y": 2, "w": 2, "h": 1 },
    { "x": 0, "y": 3, "w": 2, "h": 1 }
  ],
  [
    { "x": 0, "y": 0, "w": 2, "h": 2 },
    { "x": 0, "y": 2, "w": 2, "h": 1 },
    { "x": 0, "y": 3, "w": 2, "h": 1 }
  ],
  [
    { "x": 0, "y": 0, "w": 2, "h": 2 },
    { "x": 0, "y": 2, "w": 1, "h": 1 },
    { "x": 1, "y": 2, "w": 1, "h": 1 },
    { "x": 0, "y": 3, "w": 2, "h": 1 }
  ],
  [
    { "x": 0, "y": 0, "w": 2, "h": 2 },
    { "x": 0, "y": 2, "w": 1, "h": 1 },
    { "x": 0, "y": 2, "w": 1, "h": 1 },
    { "x": 0, "y": 3, "w": 1, "h": 1 },
    { "x": 1, "y": 3, "w": 1, "h": 1 }
  ],
  [
    { "x": 0, "y": 0, "w": 2, "h": 2 },
    { "x": 0, "y": 2, "w": 2, "h": 1 },
    { "x": 0, "y": 3, "w": 1, "h": 1 },
    { "x": 1, "y": 3, "w": 1, "h": 1 }
  ]
]
